NO textures/blue_stone.xpm
SO textures/color_stone.xpm
WE textures/eagle.xpm
EA textures/grey_stone.xpm

F 99,1,0   
C 0,0,1	

11111111 1111111111
1000101111100000001
1000100000000111101
1000111111110111101
1000110100010001001
1000110001000100011
1111111111111111111