NO textures/north.xpm
SO textures/south.xpm
WE textures/west.xpm
EA textures/east.xpm

F 20,20,20
C 200,200,200

1111111111111111111
10000011110000S0001
1011100000000111101
1000111111110111101
1110110010000000011
1000100000000010000
1111111111111111111