NO "textures/north.xpm"
SO "textures/south.xpm"
WE "textures/west.xpm"
EA "textures/east.xpm"

F	220,100,0  
C	0,0,255    

11111111 1111111111
1000101111100000001
1000100000000111101
1000111111110111101
1000110100010001001
1N00110001000100011
1111111111111111111