1111111111111111111
10000011110000W0001
1011100000000111101
1000111111110111101
1110110010000000011
1000100000000010001
1111111111111111111