1111111111111111111
1000001111100000001
1011100000000111101
1000111111110111101
1110110000000010101
1E00100001000110001
1111111111111111111