NO textures/north.xpm
SO textures/south.xpm
WE textures/west.xpm
EA textures/east.xpm

F 20,20,20
C 200,200,200

111
101
101
101
101
101
101
101
101
10111
10S01
10011
1111