NO "textures/north.xpm"
SO "textures/south.xpm"
WE "textures/west.xpm"
EA "textures/east.xpm"

F	220,100,0  
C	0,0,255    
1111111111111111111
1000011111111111111
1111000111100000001
1000100000000111101
1000111111110111101
10N0110100010001001
1000110001000100011
1111111111111111111