1111111111111111111
1C000011111C0000001
10111000000C011N101
1000111111110111101
1110110Z00000010001
10000C000100011C001
1111111111111111111