1111111111111111111
1000001111100000001
101110000000011N101
1000111111110111100
1110110000000010001
1000000001000110001
1111111111111111111