NO textures/coal.xpm
SO textures/treerings.xpm
WE textures/bookshelf.xpm
EA textures/bricks.xpm

F 220,180,10
C 222,67,255

1111111   111111111
1000001111100000001
1011100000000111101
1000111111110110101
1110110000000000101
1E00100111000110001
10000001 1111111111
10000111
11100001
  100001
  111111