1111111111111111111
1000001111100000001
1011100000000111101
1000111111110111101
1110110100010001001
1N00110001000100011
1111111111111111111