NO textures/north.xpm
SO textures/south.xpm
WE textures/west.xpm

F 20,20,20
C 200,200,200

1111111111111111111
1000001111100000001
101110000000011N101
1000111111110111101
1110110000000010001
1000000001000110001
1111111111111111111